---#--###----
-#---#----##-
-###-#-#-#-##
---#---#-#---
-#-####---##-
-#------#----
-############
------------@
